WWWWWWWWWWWWWWWWWWWWWWWWWWWWWWWW
W  W                           W
W  W                 W   WW WWWW   
W  WWWWWWWWWWWWWWWWWWW   W     W              
W                    W   W     W      
W                        W     W   
W  WWWWWWWWWWWWWWWWWW    W     W
W  W                     W     W 
W  W   WWWWWWWWWWWWWW    W     W              
W  W   W                 W     W 
W  W   W     W           WWWWWWW            
W  W   W     W                 W   
W  W         W                 W 
WWWW   W     W                 W   
W W   WW     WWWWWWWWWWWWWWWWWWW                 
W WWW                          W 
W                              W 
W  WWWWWWWWWWWWW WWWWWWWWWWWWWWW                        
W  W                           W
W  WW     WWWWWWWWWWWWWWWWWWWWWW                     
W   W     W                    W
W         WWWWWWWWWWWWWW       W             
W                      W       W
W   WWWWWWWWW    W     W       W
E           W    W     W       W
W   WWWWWWWWW    W             W
W                              W
W     WWWW WWWWWWW WWWWWWWWWWWWW                         
W     W    W                   W
W          W        W    W     W
W     WWWWWW        W    W     W
W     W             W    W     W
WWWWWWW  WWWWWWWWWWWW     WWWWWW 
W        W                     W
WWWWWWWWWWWWWWWWWWWWWWWWWWWWWWWW