WWWWWWWWWWWWWWWWWWWWWWWWWWWWWWWW
W                              W
W    WWWWWWWWWWWWWWWWWWWWWWW   W
W    W                     W   W              
W    W                     W   W      
W    WWWWWWWWWWWWWWWWWWWWWW    W       
W    W                    W    W
W    W                    W    W 
W    WWWWWWWWWWWWWWWWWWWWWW    W              
W    W   W                     W 
W    W   W     W         WWWWWWW            
W    W   W     W               W   
W              W               W 
W              W               W   
WWWWWW     WWWWWWWWWWWWWWWWWWWWW                 
WWWWWW                         W 
W                              W 
WWWWWWWWWWWWW    WWWWWWWWWWWWWWW                        
W  W                           W
W  WW                WWWW    WWW                     
W  WWWWWWWWWWWWWWWWWWWWWW      W                    
W  W      WWWWWWWWWWWWWW       W             
W  W                    W      W
WWWWWWWWWWWWW    W     W       W
W           W    W     W       W
W   WWWWWWWWW    W             W
W                              W
W     WWWW WWWWWWW WWWWWWWWWWWWW                         
W     W    W                   W
W          W        W    W     W
W     WWWWWW        W    W     W
W     W             W    W     W
WWWWWWW  WWWWWWWWWWWW        WWW 
W        W                     W
WWWWWWWWWWWWWWWWWWWWWWWWWWEWWWWW
